"filename", "language", "JSON", "Markdown", "mcfunction", "comment", "blank", "total"
"c:\Users\Flynn\AppData\Roaming\.minecraft\saves\Hexenwerk Test World\datapacks\Hexenwerk-Datapack\README.md", "Markdown", 0, 1, 0, 0, 1, 2
"c:\Users\Flynn\AppData\Roaming\.minecraft\saves\Hexenwerk Test World\datapacks\Hexenwerk-Datapack\data\hexenwerk\advancements\craft\magical_crafting_table.json", "JSON", 14, 0, 0, 0, 1, 15
"c:\Users\Flynn\AppData\Roaming\.minecraft\saves\Hexenwerk Test World\datapacks\Hexenwerk-Datapack\data\hexenwerk\advancements\craft\magical_crystal.json", "JSON", 14, 0, 0, 0, 1, 15
"c:\Users\Flynn\AppData\Roaming\.minecraft\saves\Hexenwerk Test World\datapacks\Hexenwerk-Datapack\data\hexenwerk\advancements\craft\wand.json", "JSON", 14, 0, 0, 0, 1, 15
"c:\Users\Flynn\AppData\Roaming\.minecraft\saves\Hexenwerk Test World\datapacks\Hexenwerk-Datapack\data\hexenwerk\advancements\crystal.json", "JSON", 34, 0, 0, 0, 0, 34
"c:\Users\Flynn\AppData\Roaming\.minecraft\saves\Hexenwerk Test World\datapacks\Hexenwerk-Datapack\data\hexenwerk\advancements\magical_crafting_table.json", "JSON", 34, 0, 0, 0, 0, 34
"c:\Users\Flynn\AppData\Roaming\.minecraft\saves\Hexenwerk Test World\datapacks\Hexenwerk-Datapack\data\hexenwerk\advancements\root.json", "JSON", 26, 0, 0, 0, 0, 26
"c:\Users\Flynn\AppData\Roaming\.minecraft\saves\Hexenwerk Test World\datapacks\Hexenwerk-Datapack\data\hexenwerk\advancements\shard.json", "JSON", 34, 0, 0, 0, 0, 34
"c:\Users\Flynn\AppData\Roaming\.minecraft\saves\Hexenwerk Test World\datapacks\Hexenwerk-Datapack\data\hexenwerk\advancements\spell.json", "JSON", 26, 0, 0, 0, 0, 26
"c:\Users\Flynn\AppData\Roaming\.minecraft\saves\Hexenwerk Test World\datapacks\Hexenwerk-Datapack\data\hexenwerk\advancements\wand.json", "JSON", 34, 0, 0, 0, 0, 34
"c:\Users\Flynn\AppData\Roaming\.minecraft\saves\Hexenwerk Test World\datapacks\Hexenwerk-Datapack\data\hexenwerk\functions\blocks\magical_crafting_table\destroy.mcfunction", "mcfunction", 0, 0, 6, 0, 0, 6
"c:\Users\Flynn\AppData\Roaming\.minecraft\saves\Hexenwerk Test World\datapacks\Hexenwerk-Datapack\data\hexenwerk\functions\blocks\magical_crafting_table\gui\check_extra\magical.mcfunction", "mcfunction", 0, 0, 55, 0, 6, 61
"c:\Users\Flynn\AppData\Roaming\.minecraft\saves\Hexenwerk Test World\datapacks\Hexenwerk-Datapack\data\hexenwerk\functions\blocks\magical_crafting_table\gui\check_extra\wand.mcfunction", "mcfunction", 0, 0, 73, 0, 6, 79
"c:\Users\Flynn\AppData\Roaming\.minecraft\saves\Hexenwerk Test World\datapacks\Hexenwerk-Datapack\data\hexenwerk\functions\blocks\magical_crafting_table\gui\fix_items.mcfunction", "mcfunction", 0, 0, 3, 0, 3, 6
"c:\Users\Flynn\AppData\Roaming\.minecraft\saves\Hexenwerk Test World\datapacks\Hexenwerk-Datapack\data\hexenwerk\functions\blocks\magical_crafting_table\gui\mask\magical.mcfunction", "mcfunction", 0, 0, 3, 0, 2, 5
"c:\Users\Flynn\AppData\Roaming\.minecraft\saves\Hexenwerk Test World\datapacks\Hexenwerk-Datapack\data\hexenwerk\functions\blocks\magical_crafting_table\gui\mask\main.mcfunction", "mcfunction", 0, 0, 2, 0, 0, 2
"c:\Users\Flynn\AppData\Roaming\.minecraft\saves\Hexenwerk Test World\datapacks\Hexenwerk-Datapack\data\hexenwerk\functions\blocks\magical_crafting_table\gui\mask\wand.mcfunction", "mcfunction", 0, 0, 3, 0, 2, 5
"c:\Users\Flynn\AppData\Roaming\.minecraft\saves\Hexenwerk Test World\datapacks\Hexenwerk-Datapack\data\hexenwerk\functions\blocks\magical_crafting_table\magical\main.mcfunction", "mcfunction", 0, 0, 0, 0, 1, 1
"c:\Users\Flynn\AppData\Roaming\.minecraft\saves\Hexenwerk Test World\datapacks\Hexenwerk-Datapack\data\hexenwerk\functions\blocks\magical_crafting_table\main.mcfunction", "mcfunction", 0, 0, 4, 0, 3, 7
"c:\Users\Flynn\AppData\Roaming\.minecraft\saves\Hexenwerk Test World\datapacks\Hexenwerk-Datapack\data\hexenwerk\functions\blocks\magical_crafting_table\place.mcfunction", "mcfunction", 0, 0, 10, 0, 4, 14
"c:\Users\Flynn\AppData\Roaming\.minecraft\saves\Hexenwerk Test World\datapacks\Hexenwerk-Datapack\data\hexenwerk\functions\blocks\magical_crafting_table\switch_mode\crafting.mcfunction", "mcfunction", 0, 0, 5, 0, 2, 7
"c:\Users\Flynn\AppData\Roaming\.minecraft\saves\Hexenwerk Test World\datapacks\Hexenwerk-Datapack\data\hexenwerk\functions\blocks\magical_crafting_table\switch_mode\remove_items\crafting.mcfunction", "mcfunction", 0, 0, 29, 0, 6, 35
"c:\Users\Flynn\AppData\Roaming\.minecraft\saves\Hexenwerk Test World\datapacks\Hexenwerk-Datapack\data\hexenwerk\functions\blocks\magical_crafting_table\switch_mode\remove_items\magical.mcfunction", "mcfunction", 0, 0, 53, 0, 2, 55
"c:\Users\Flynn\AppData\Roaming\.minecraft\saves\Hexenwerk Test World\datapacks\Hexenwerk-Datapack\data\hexenwerk\functions\blocks\magical_crafting_table\switch_mode\wand.mcfunction", "mcfunction", 0, 0, 5, 0, 2, 7
"c:\Users\Flynn\AppData\Roaming\.minecraft\saves\Hexenwerk Test World\datapacks\Hexenwerk-Datapack\data\hexenwerk\functions\blocks\magical_crafting_table\wand\apply\first.mcfunction", "mcfunction", 0, 0, 6, 0, 1, 7
"c:\Users\Flynn\AppData\Roaming\.minecraft\saves\Hexenwerk Test World\datapacks\Hexenwerk-Datapack\data\hexenwerk\functions\blocks\magical_crafting_table\wand\apply\main.mcfunction", "mcfunction", 0, 0, 6, 0, 2, 8
"c:\Users\Flynn\AppData\Roaming\.minecraft\saves\Hexenwerk Test World\datapacks\Hexenwerk-Datapack\data\hexenwerk\functions\blocks\magical_crafting_table\wand\apply\remove\first.mcfunction", "mcfunction", 0, 0, 6, 0, 1, 7
"c:\Users\Flynn\AppData\Roaming\.minecraft\saves\Hexenwerk Test World\datapacks\Hexenwerk-Datapack\data\hexenwerk\functions\blocks\magical_crafting_table\wand\apply\remove\second.mcfunction", "mcfunction", 0, 0, 6, 0, 1, 7
"c:\Users\Flynn\AppData\Roaming\.minecraft\saves\Hexenwerk Test World\datapacks\Hexenwerk-Datapack\data\hexenwerk\functions\blocks\magical_crafting_table\wand\apply\remove\third.mcfunction", "mcfunction", 0, 0, 6, 0, 1, 7
"c:\Users\Flynn\AppData\Roaming\.minecraft\saves\Hexenwerk Test World\datapacks\Hexenwerk-Datapack\data\hexenwerk\functions\blocks\magical_crafting_table\wand\apply\second.mcfunction", "mcfunction", 0, 0, 6, 0, 1, 7
"c:\Users\Flynn\AppData\Roaming\.minecraft\saves\Hexenwerk Test World\datapacks\Hexenwerk-Datapack\data\hexenwerk\functions\blocks\magical_crafting_table\wand\apply\third.mcfunction", "mcfunction", 0, 0, 6, 0, 1, 7
"c:\Users\Flynn\AppData\Roaming\.minecraft\saves\Hexenwerk Test World\datapacks\Hexenwerk-Datapack\data\hexenwerk\functions\blocks\magical_crafting_table\wand\load_books\first.mcfunction", "mcfunction", 0, 0, 7, 0, 1, 8
"c:\Users\Flynn\AppData\Roaming\.minecraft\saves\Hexenwerk Test World\datapacks\Hexenwerk-Datapack\data\hexenwerk\functions\blocks\magical_crafting_table\wand\load_books\kick_items\first.mcfunction", "mcfunction", 0, 0, 6, 0, 0, 6
"c:\Users\Flynn\AppData\Roaming\.minecraft\saves\Hexenwerk Test World\datapacks\Hexenwerk-Datapack\data\hexenwerk\functions\blocks\magical_crafting_table\wand\load_books\kick_items\main.mcfunction", "mcfunction", 0, 0, 3, 0, 0, 3
"c:\Users\Flynn\AppData\Roaming\.minecraft\saves\Hexenwerk Test World\datapacks\Hexenwerk-Datapack\data\hexenwerk\functions\blocks\magical_crafting_table\wand\load_books\kick_items\second.mcfunction", "mcfunction", 0, 0, 6, 0, 0, 6
"c:\Users\Flynn\AppData\Roaming\.minecraft\saves\Hexenwerk Test World\datapacks\Hexenwerk-Datapack\data\hexenwerk\functions\blocks\magical_crafting_table\wand\load_books\kick_items\third.mcfunction", "mcfunction", 0, 0, 6, 0, 1, 7
"c:\Users\Flynn\AppData\Roaming\.minecraft\saves\Hexenwerk Test World\datapacks\Hexenwerk-Datapack\data\hexenwerk\functions\blocks\magical_crafting_table\wand\load_books\main.mcfunction", "mcfunction", 0, 0, 7, 0, 1, 8
"c:\Users\Flynn\AppData\Roaming\.minecraft\saves\Hexenwerk Test World\datapacks\Hexenwerk-Datapack\data\hexenwerk\functions\blocks\magical_crafting_table\wand\load_books\second.mcfunction", "mcfunction", 0, 0, 7, 0, 1, 8
"c:\Users\Flynn\AppData\Roaming\.minecraft\saves\Hexenwerk Test World\datapacks\Hexenwerk-Datapack\data\hexenwerk\functions\blocks\magical_crafting_table\wand\load_books\third.mcfunction", "mcfunction", 0, 0, 7, 0, 1, 8
"c:\Users\Flynn\AppData\Roaming\.minecraft\saves\Hexenwerk Test World\datapacks\Hexenwerk-Datapack\data\hexenwerk\functions\blocks\magical_crafting_table\wand\main.mcfunction", "mcfunction", 0, 0, 5, 0, 2, 7
"c:\Users\Flynn\AppData\Roaming\.minecraft\saves\Hexenwerk Test World\datapacks\Hexenwerk-Datapack\data\hexenwerk\functions\blocks\magical_crafting_table\wand\remove_wand.mcfunction", "mcfunction", 0, 0, 3, 0, 0, 3
"c:\Users\Flynn\AppData\Roaming\.minecraft\saves\Hexenwerk Test World\datapacks\Hexenwerk-Datapack\data\hexenwerk\functions\blocks\magical_flower\destroy.mcfunction", "mcfunction", 0, 0, 4, 0, 0, 4
"c:\Users\Flynn\AppData\Roaming\.minecraft\saves\Hexenwerk Test World\datapacks\Hexenwerk-Datapack\data\hexenwerk\functions\blocks\magical_flower\place.mcfunction", "mcfunction", 0, 0, 6, 0, 2, 8
"c:\Users\Flynn\AppData\Roaming\.minecraft\saves\Hexenwerk Test World\datapacks\Hexenwerk-Datapack\data\hexenwerk\functions\blocks\main.mcfunction", "mcfunction", 0, 0, 4, 0, 1, 5
"c:\Users\Flynn\AppData\Roaming\.minecraft\saves\Hexenwerk Test World\datapacks\Hexenwerk-Datapack\data\hexenwerk\functions\blocks\main_place.mcfunction", "mcfunction", 0, 0, 3, 0, 2, 5
"c:\Users\Flynn\AppData\Roaming\.minecraft\saves\Hexenwerk Test World\datapacks\Hexenwerk-Datapack\data\hexenwerk\functions\config.mcfunction", "mcfunction", 0, 0, 2, 3, 2, 7
"c:\Users\Flynn\AppData\Roaming\.minecraft\saves\Hexenwerk Test World\datapacks\Hexenwerk-Datapack\data\hexenwerk\functions\craft\magical_crafting_table.mcfunction", "mcfunction", 0, 0, 9, 0, 0, 9
"c:\Users\Flynn\AppData\Roaming\.minecraft\saves\Hexenwerk Test World\datapacks\Hexenwerk-Datapack\data\hexenwerk\functions\craft\magical_crystal.mcfunction", "mcfunction", 0, 0, 9, 0, 1, 10
"c:\Users\Flynn\AppData\Roaming\.minecraft\saves\Hexenwerk Test World\datapacks\Hexenwerk-Datapack\data\hexenwerk\functions\craft\wand.mcfunction", "mcfunction", 0, 0, 9, 0, 1, 10
"c:\Users\Flynn\AppData\Roaming\.minecraft\saves\Hexenwerk Test World\datapacks\Hexenwerk-Datapack\data\hexenwerk\functions\dev\dev_stone\swap_spell\down.mcfunction", "mcfunction", 0, 0, 7, 0, 0, 7
"c:\Users\Flynn\AppData\Roaming\.minecraft\saves\Hexenwerk Test World\datapacks\Hexenwerk-Datapack\data\hexenwerk\functions\dev\dev_stone\swap_spell\up.mcfunction", "mcfunction", 0, 0, 7, 0, 0, 7
"c:\Users\Flynn\AppData\Roaming\.minecraft\saves\Hexenwerk Test World\datapacks\Hexenwerk-Datapack\data\hexenwerk\functions\dev\dev_stone\switch\debug.mcfunction", "mcfunction", 0, 0, 4, 0, 0, 4
"c:\Users\Flynn\AppData\Roaming\.minecraft\saves\Hexenwerk Test World\datapacks\Hexenwerk-Datapack\data\hexenwerk\functions\dev\dev_stone\switch\dev.mcfunction", "mcfunction", 0, 0, 6, 0, 0, 6
"c:\Users\Flynn\AppData\Roaming\.minecraft\saves\Hexenwerk Test World\datapacks\Hexenwerk-Datapack\data\hexenwerk\functions\dev\dev_stone\switch\disabled.mcfunction", "mcfunction", 0, 0, 5, 0, 1, 6
"c:\Users\Flynn\AppData\Roaming\.minecraft\saves\Hexenwerk Test World\datapacks\Hexenwerk-Datapack\data\hexenwerk\functions\dev\dev_stone\toggle.mcfunction", "mcfunction", 0, 0, 4, 0, 0, 4
"c:\Users\Flynn\AppData\Roaming\.minecraft\saves\Hexenwerk Test World\datapacks\Hexenwerk-Datapack\data\hexenwerk\functions\load.mcfunction", "mcfunction", 0, 0, 24, 4, 6, 34
"c:\Users\Flynn\AppData\Roaming\.minecraft\saves\Hexenwerk Test World\datapacks\Hexenwerk-Datapack\data\hexenwerk\functions\main.mcfunction", "mcfunction", 0, 0, 22, 6, 5, 33
"c:\Users\Flynn\AppData\Roaming\.minecraft\saves\Hexenwerk Test World\datapacks\Hexenwerk-Datapack\data\hexenwerk\functions\mana\display.mcfunction", "mcfunction", 0, 0, 24, 0, 1, 25
"c:\Users\Flynn\AppData\Roaming\.minecraft\saves\Hexenwerk Test World\datapacks\Hexenwerk-Datapack\data\hexenwerk\functions\mana\display_water.mcfunction", "mcfunction", 0, 0, 24, 0, 1, 25
"c:\Users\Flynn\AppData\Roaming\.minecraft\saves\Hexenwerk Test World\datapacks\Hexenwerk-Datapack\data\hexenwerk\functions\mana\on_death.mcfunction", "mcfunction", 0, 0, 3, 0, 1, 4
"c:\Users\Flynn\AppData\Roaming\.minecraft\saves\Hexenwerk Test World\datapacks\Hexenwerk-Datapack\data\hexenwerk\functions\mana\regen.mcfunction", "mcfunction", 0, 0, 7, 0, 1, 8
"c:\Users\Flynn\AppData\Roaming\.minecraft\saves\Hexenwerk Test World\datapacks\Hexenwerk-Datapack\data\hexenwerk\functions\mana\regen_of_flower.mcfunction", "mcfunction", 0, 0, 2, 0, 1, 3
"c:\Users\Flynn\AppData\Roaming\.minecraft\saves\Hexenwerk Test World\datapacks\Hexenwerk-Datapack\data\hexenwerk\functions\mana\run_regen.mcfunction", "mcfunction", 0, 0, 2, 0, 1, 3
"c:\Users\Flynn\AppData\Roaming\.minecraft\saves\Hexenwerk Test World\datapacks\Hexenwerk-Datapack\data\hexenwerk\functions\spell_events\end\circulum_sanitatem.mcfunction", "mcfunction", 0, 0, 6, 0, 0, 6
"c:\Users\Flynn\AppData\Roaming\.minecraft\saves\Hexenwerk Test World\datapacks\Hexenwerk-Datapack\data\hexenwerk\functions\spell_events\end\ignis_temptates.mcfunction", "mcfunction", 0, 0, 26, 0, 12, 38
"c:\Users\Flynn\AppData\Roaming\.minecraft\saves\Hexenwerk Test World\datapacks\Hexenwerk-Datapack\data\hexenwerk\functions\spell_events\main.mcfunction", "mcfunction", 0, 0, 5, 0, 1, 6
"c:\Users\Flynn\AppData\Roaming\.minecraft\saves\Hexenwerk Test World\datapacks\Hexenwerk-Datapack\data\hexenwerk\functions\spell_events\start\circulum_sanitatem.mcfunction", "mcfunction", 0, 0, 0, 0, 1, 1
"c:\Users\Flynn\AppData\Roaming\.minecraft\saves\Hexenwerk Test World\datapacks\Hexenwerk-Datapack\data\hexenwerk\functions\spell_events\start\ignis_temptates.mcfunction", "mcfunction", 0, 0, 1, 0, 0, 1
"c:\Users\Flynn\AppData\Roaming\.minecraft\saves\Hexenwerk Test World\datapacks\Hexenwerk-Datapack\data\hexenwerk\functions\spell_events\start\main.mcfunction", "mcfunction", 0, 0, 3, 0, 1, 4
"c:\Users\Flynn\AppData\Roaming\.minecraft\saves\Hexenwerk Test World\datapacks\Hexenwerk-Datapack\data\hexenwerk\functions\spell_events\while\circulum_sanitatem.mcfunction", "mcfunction", 0, 0, 6, 0, 3, 9
"c:\Users\Flynn\AppData\Roaming\.minecraft\saves\Hexenwerk Test World\datapacks\Hexenwerk-Datapack\data\hexenwerk\functions\spell_events\while\ignis_temptates.mcfunction", "mcfunction", 0, 0, 9, 0, 2, 11
"c:\Users\Flynn\AppData\Roaming\.minecraft\saves\Hexenwerk Test World\datapacks\Hexenwerk-Datapack\data\hexenwerk\functions\spell_events\while\main.mcfunction", "mcfunction", 0, 0, 2, 0, 1, 3
"c:\Users\Flynn\AppData\Roaming\.minecraft\saves\Hexenwerk Test World\datapacks\Hexenwerk-Datapack\data\hexenwerk\functions\uninstall.mcfunction", "mcfunction", 0, 0, 20, 0, 4, 24
"c:\Users\Flynn\AppData\Roaming\.minecraft\saves\Hexenwerk Test World\datapacks\Hexenwerk-Datapack\data\hexenwerk\functions\utility\drop_from_mainhand.mcfunction", "mcfunction", 0, 0, 5, 0, 2, 7
"c:\Users\Flynn\AppData\Roaming\.minecraft\saves\Hexenwerk Test World\datapacks\Hexenwerk-Datapack\data\hexenwerk\functions\utility\drop_from_offhand.mcfunction", "mcfunction", 0, 0, 5, 0, 2, 7
"c:\Users\Flynn\AppData\Roaming\.minecraft\saves\Hexenwerk Test World\datapacks\Hexenwerk-Datapack\data\hexenwerk\functions\wand\main.mcfunction", "mcfunction", 0, 0, 6, 0, 2, 8
"c:\Users\Flynn\AppData\Roaming\.minecraft\saves\Hexenwerk Test World\datapacks\Hexenwerk-Datapack\data\hexenwerk\functions\wand\slot_1\main.mcfunction", "mcfunction", 0, 0, 10, 2, 6, 18
"c:\Users\Flynn\AppData\Roaming\.minecraft\saves\Hexenwerk Test World\datapacks\Hexenwerk-Datapack\data\hexenwerk\functions\wand\slot_1\swapto.mcfunction", "mcfunction", 0, 0, 10, 0, 5, 15
"c:\Users\Flynn\AppData\Roaming\.minecraft\saves\Hexenwerk Test World\datapacks\Hexenwerk-Datapack\data\hexenwerk\functions\wand\slot_2\main.mcfunction", "mcfunction", 0, 0, 10, 2, 5, 17
"c:\Users\Flynn\AppData\Roaming\.minecraft\saves\Hexenwerk Test World\datapacks\Hexenwerk-Datapack\data\hexenwerk\functions\wand\slot_2\swapto.mcfunction", "mcfunction", 0, 0, 10, 0, 4, 14
"c:\Users\Flynn\AppData\Roaming\.minecraft\saves\Hexenwerk Test World\datapacks\Hexenwerk-Datapack\data\hexenwerk\functions\wand\slot_3\main.mcfunction", "mcfunction", 0, 0, 10, 2, 4, 16
"c:\Users\Flynn\AppData\Roaming\.minecraft\saves\Hexenwerk Test World\datapacks\Hexenwerk-Datapack\data\hexenwerk\functions\wand\slot_3\swapto.mcfunction", "mcfunction", 0, 0, 10, 0, 4, 14
"c:\Users\Flynn\AppData\Roaming\.minecraft\saves\Hexenwerk Test World\datapacks\Hexenwerk-Datapack\data\hexenwerk\functions\wand\spells\cast.mcfunction", "mcfunction", 0, 0, 6, 0, 2, 8
"c:\Users\Flynn\AppData\Roaming\.minecraft\saves\Hexenwerk Test World\datapacks\Hexenwerk-Datapack\data\hexenwerk\functions\wand\spells\no_raycast\main.mcfunction", "mcfunction", 0, 0, 14, 0, 4, 18
"c:\Users\Flynn\AppData\Roaming\.minecraft\saves\Hexenwerk Test World\datapacks\Hexenwerk-Datapack\data\hexenwerk\functions\wand\spells\no_raycast\spells_effect\amogius.mcfunction", "mcfunction", 0, 0, 2, 0, 1, 3
"c:\Users\Flynn\AppData\Roaming\.minecraft\saves\Hexenwerk Test World\datapacks\Hexenwerk-Datapack\data\hexenwerk\functions\wand\spells\no_raycast\spells_effect\auxiliare.mcfunction", "mcfunction", 0, 0, 5, 0, 2, 7
"c:\Users\Flynn\AppData\Roaming\.minecraft\saves\Hexenwerk Test World\datapacks\Hexenwerk-Datapack\data\hexenwerk\functions\wand\spells\no_raycast\spells_effect\circulum_sanitatem.mcfunction", "mcfunction", 0, 0, 3, 0, 2, 5
"c:\Users\Flynn\AppData\Roaming\.minecraft\saves\Hexenwerk Test World\datapacks\Hexenwerk-Datapack\data\hexenwerk\functions\wand\spells\no_raycast\spells_effect\commovus.mcfunction", "mcfunction", 0, 0, 3, 0, 4, 7
"c:\Users\Flynn\AppData\Roaming\.minecraft\saves\Hexenwerk Test World\datapacks\Hexenwerk-Datapack\data\hexenwerk\functions\wand\spells\raycast\block_impact.mcfunction", "mcfunction", 0, 0, 9, 0, 1, 10
"c:\Users\Flynn\AppData\Roaming\.minecraft\saves\Hexenwerk Test World\datapacks\Hexenwerk-Datapack\data\hexenwerk\functions\wand\spells\raycast\entity_impact.mcfunction", "mcfunction", 0, 0, 8, 0, 0, 8
"c:\Users\Flynn\AppData\Roaming\.minecraft\saves\Hexenwerk Test World\datapacks\Hexenwerk-Datapack\data\hexenwerk\functions\wand\spells\raycast\main.mcfunction", "mcfunction", 0, 0, 13, 0, 4, 17
"c:\Users\Flynn\AppData\Roaming\.minecraft\saves\Hexenwerk Test World\datapacks\Hexenwerk-Datapack\data\hexenwerk\functions\wand\spells\raycast\raycast.mcfunction", "mcfunction", 0, 0, 13, 1, 10, 24
"c:\Users\Flynn\AppData\Roaming\.minecraft\saves\Hexenwerk Test World\datapacks\Hexenwerk-Datapack\data\hexenwerk\functions\wand\spells\raycast\spells_impact\block\aguamenti.mcfunction", "mcfunction", 0, 0, 7, 0, 1, 8
"c:\Users\Flynn\AppData\Roaming\.minecraft\saves\Hexenwerk Test World\datapacks\Hexenwerk-Datapack\data\hexenwerk\functions\wand\spells\raycast\spells_impact\block\ardo.mcfunction", "mcfunction", 0, 0, 4, 0, 0, 4
"c:\Users\Flynn\AppData\Roaming\.minecraft\saves\Hexenwerk Test World\datapacks\Hexenwerk-Datapack\data\hexenwerk\functions\wand\spells\raycast\spells_impact\block\attonus.mcfunction", "mcfunction", 0, 0, 3, 0, 1, 4
"c:\Users\Flynn\AppData\Roaming\.minecraft\saves\Hexenwerk Test World\datapacks\Hexenwerk-Datapack\data\hexenwerk\functions\wand\spells\raycast\spells_impact\block\consedo.mcfunction", "mcfunction", 0, 0, 4, 0, 1, 5
"c:\Users\Flynn\AppData\Roaming\.minecraft\saves\Hexenwerk Test World\datapacks\Hexenwerk-Datapack\data\hexenwerk\functions\wand\spells\raycast\spells_impact\block\iunior.mcfunction", "mcfunction", 0, 0, 2, 0, 1, 3
"c:\Users\Flynn\AppData\Roaming\.minecraft\saves\Hexenwerk Test World\datapacks\Hexenwerk-Datapack\data\hexenwerk\functions\wand\spells\raycast\spells_impact\block\wingardium_leviosa.mcfunction", "mcfunction", 0, 0, 4, 0, 1, 5
"c:\Users\Flynn\AppData\Roaming\.minecraft\saves\Hexenwerk Test World\datapacks\Hexenwerk-Datapack\data\hexenwerk\functions\wand\spells\raycast\spells_impact\entity\aguamenti.mcfunction", "mcfunction", 0, 0, 5, 0, 1, 6
"c:\Users\Flynn\AppData\Roaming\.minecraft\saves\Hexenwerk Test World\datapacks\Hexenwerk-Datapack\data\hexenwerk\functions\wand\spells\raycast\spells_impact\entity\ardo.mcfunction", "mcfunction", 0, 0, 4, 0, 3, 7
"c:\Users\Flynn\AppData\Roaming\.minecraft\saves\Hexenwerk Test World\datapacks\Hexenwerk-Datapack\data\hexenwerk\functions\wand\spells\raycast\spells_impact\entity\attonus.mcfunction", "mcfunction", 0, 0, 3, 0, 1, 4
"c:\Users\Flynn\AppData\Roaming\.minecraft\saves\Hexenwerk Test World\datapacks\Hexenwerk-Datapack\data\hexenwerk\functions\wand\spells\raycast\spells_impact\entity\consedo.mcfunction", "mcfunction", 0, 0, 3, 0, 1, 4
"c:\Users\Flynn\AppData\Roaming\.minecraft\saves\Hexenwerk Test World\datapacks\Hexenwerk-Datapack\data\hexenwerk\functions\wand\spells\raycast\spells_impact\entity\iunior.mcfunction", "mcfunction", 0, 0, 7, 0, 2, 9
"c:\Users\Flynn\AppData\Roaming\.minecraft\saves\Hexenwerk Test World\datapacks\Hexenwerk-Datapack\data\hexenwerk\functions\wand\spells\raycast\spells_impact\entity\wingardium_leviosa.mcfunction", "mcfunction", 0, 0, 3, 0, 2, 5
"c:\Users\Flynn\AppData\Roaming\.minecraft\saves\Hexenwerk Test World\datapacks\Hexenwerk-Datapack\data\hexenwerk\functions\wand\spells\raycast\spells_impact\ignis_temptates.mcfunction", "mcfunction", 0, 0, 3, 0, 1, 4
"c:\Users\Flynn\AppData\Roaming\.minecraft\saves\Hexenwerk Test World\datapacks\Hexenwerk-Datapack\data\hexenwerk\functions\wand\swapslot.mcfunction", "mcfunction", 0, 0, 7, 0, 3, 10
"c:\Users\Flynn\AppData\Roaming\.minecraft\saves\Hexenwerk Test World\datapacks\Hexenwerk-Datapack\data\hexenwerk\functions\wand\swapslot_offhand.mcfunction", "mcfunction", 0, 0, 7, 0, 3, 10
"c:\Users\Flynn\AppData\Roaming\.minecraft\saves\Hexenwerk Test World\datapacks\Hexenwerk-Datapack\data\hexenwerk\functions\wand\use.mcfunction", "mcfunction", 0, 0, 7, 0, 3, 10
"c:\Users\Flynn\AppData\Roaming\.minecraft\saves\Hexenwerk Test World\datapacks\Hexenwerk-Datapack\data\hexenwerk\item_modifiers\dev_stone\storage_to_wand.json", "JSON", 16, 0, 0, 0, 1, 17
"c:\Users\Flynn\AppData\Roaming\.minecraft\saves\Hexenwerk Test World\datapacks\Hexenwerk-Datapack\data\hexenwerk\item_modifiers\dev_stone\to_deactivated.json", "JSON", 6, 0, 0, 0, 1, 7
"c:\Users\Flynn\AppData\Roaming\.minecraft\saves\Hexenwerk Test World\datapacks\Hexenwerk-Datapack\data\hexenwerk\item_modifiers\dev_stone\to_debug.json", "JSON", 6, 0, 0, 0, 1, 7
"c:\Users\Flynn\AppData\Roaming\.minecraft\saves\Hexenwerk Test World\datapacks\Hexenwerk-Datapack\data\hexenwerk\item_modifiers\dev_stone\to_dev.json", "JSON", 6, 0, 0, 0, 1, 7
"c:\Users\Flynn\AppData\Roaming\.minecraft\saves\Hexenwerk Test World\datapacks\Hexenwerk-Datapack\data\hexenwerk\item_modifiers\swap_wand_slot\first.json", "JSON", 6, 0, 0, 0, 1, 7
"c:\Users\Flynn\AppData\Roaming\.minecraft\saves\Hexenwerk Test World\datapacks\Hexenwerk-Datapack\data\hexenwerk\item_modifiers\swap_wand_slot\second.json", "JSON", 6, 0, 0, 0, 1, 7
"c:\Users\Flynn\AppData\Roaming\.minecraft\saves\Hexenwerk Test World\datapacks\Hexenwerk-Datapack\data\hexenwerk\item_modifiers\swap_wand_slot\third.json", "JSON", 6, 0, 0, 0, 1, 7
"c:\Users\Flynn\AppData\Roaming\.minecraft\saves\Hexenwerk Test World\datapacks\Hexenwerk-Datapack\data\hexenwerk\loot_tables\blocks\magical_crafting_table.json", "JSON", 19, 0, 0, 0, 1, 20
"c:\Users\Flynn\AppData\Roaming\.minecraft\saves\Hexenwerk Test World\datapacks\Hexenwerk-Datapack\data\hexenwerk\loot_tables\blocks\magical_flower.json", "JSON", 19, 0, 0, 0, 1, 20
"c:\Users\Flynn\AppData\Roaming\.minecraft\saves\Hexenwerk Test World\datapacks\Hexenwerk-Datapack\data\hexenwerk\loot_tables\blocks\wand_crafter.json", "JSON", 22, 0, 0, 0, 1, 23
"c:\Users\Flynn\AppData\Roaming\.minecraft\saves\Hexenwerk Test World\datapacks\Hexenwerk-Datapack\data\hexenwerk\loot_tables\items\dev_stone.json", "JSON", 19, 0, 0, 0, 1, 20
"c:\Users\Flynn\AppData\Roaming\.minecraft\saves\Hexenwerk Test World\datapacks\Hexenwerk-Datapack\data\hexenwerk\loot_tables\items\magical_crystal.json", "JSON", 19, 0, 0, 0, 1, 20
"c:\Users\Flynn\AppData\Roaming\.minecraft\saves\Hexenwerk Test World\datapacks\Hexenwerk-Datapack\data\hexenwerk\loot_tables\items\magical_shard.json", "JSON", 22, 0, 0, 0, 1, 23
"c:\Users\Flynn\AppData\Roaming\.minecraft\saves\Hexenwerk Test World\datapacks\Hexenwerk-Datapack\data\hexenwerk\loot_tables\items\spell_books\aguamenti.json", "JSON", 19, 0, 0, 0, 0, 19
"c:\Users\Flynn\AppData\Roaming\.minecraft\saves\Hexenwerk Test World\datapacks\Hexenwerk-Datapack\data\hexenwerk\loot_tables\items\spell_books\amogius.json", "JSON", 19, 0, 0, 0, 1, 20
"c:\Users\Flynn\AppData\Roaming\.minecraft\saves\Hexenwerk Test World\datapacks\Hexenwerk-Datapack\data\hexenwerk\loot_tables\items\spell_books\ardo.json", "JSON", 19, 0, 0, 0, 1, 20
"c:\Users\Flynn\AppData\Roaming\.minecraft\saves\Hexenwerk Test World\datapacks\Hexenwerk-Datapack\data\hexenwerk\loot_tables\items\spell_books\attonus.json", "JSON", 19, 0, 0, 0, 1, 20
"c:\Users\Flynn\AppData\Roaming\.minecraft\saves\Hexenwerk Test World\datapacks\Hexenwerk-Datapack\data\hexenwerk\loot_tables\items\spell_books\auxiliare.json", "JSON", 19, 0, 0, 0, 1, 20
"c:\Users\Flynn\AppData\Roaming\.minecraft\saves\Hexenwerk Test World\datapacks\Hexenwerk-Datapack\data\hexenwerk\loot_tables\items\spell_books\circulum_sanitatem.json", "JSON", 19, 0, 0, 0, 1, 20
"c:\Users\Flynn\AppData\Roaming\.minecraft\saves\Hexenwerk Test World\datapacks\Hexenwerk-Datapack\data\hexenwerk\loot_tables\items\spell_books\commovus.json", "JSON", 19, 0, 0, 0, 1, 20
"c:\Users\Flynn\AppData\Roaming\.minecraft\saves\Hexenwerk Test World\datapacks\Hexenwerk-Datapack\data\hexenwerk\loot_tables\items\spell_books\consedo.json", "JSON", 19, 0, 0, 0, 1, 20
"c:\Users\Flynn\AppData\Roaming\.minecraft\saves\Hexenwerk Test World\datapacks\Hexenwerk-Datapack\data\hexenwerk\loot_tables\items\spell_books\ignis_temptates.json", "JSON", 19, 0, 0, 0, 0, 19
"c:\Users\Flynn\AppData\Roaming\.minecraft\saves\Hexenwerk Test World\datapacks\Hexenwerk-Datapack\data\hexenwerk\loot_tables\items\spell_books\iunior.json", "JSON", 19, 0, 0, 0, 0, 19
"c:\Users\Flynn\AppData\Roaming\.minecraft\saves\Hexenwerk Test World\datapacks\Hexenwerk-Datapack\data\hexenwerk\loot_tables\items\spell_books\wingardium_leviosa.json", "JSON", 19, 0, 0, 0, 1, 20
"c:\Users\Flynn\AppData\Roaming\.minecraft\saves\Hexenwerk Test World\datapacks\Hexenwerk-Datapack\data\hexenwerk\loot_tables\items\wand.json", "JSON", 18, 0, 0, 0, 1, 19
"c:\Users\Flynn\AppData\Roaming\.minecraft\saves\Hexenwerk Test World\datapacks\Hexenwerk-Datapack\data\hexenwerk\predicates\1_percent.json", "JSON", 4, 0, 0, 0, 1, 5
"c:\Users\Flynn\AppData\Roaming\.minecraft\saves\Hexenwerk Test World\datapacks\Hexenwerk-Datapack\data\hexenwerk\predicates\20_percent.json", "JSON", 4, 0, 0, 0, 1, 5
"c:\Users\Flynn\AppData\Roaming\.minecraft\saves\Hexenwerk Test World\datapacks\Hexenwerk-Datapack\data\hexenwerk\predicates\5_percent.json", "JSON", 4, 0, 0, 0, 1, 5
"c:\Users\Flynn\AppData\Roaming\.minecraft\saves\Hexenwerk Test World\datapacks\Hexenwerk-Datapack\data\hexenwerk\predicates\75_percent.json", "JSON", 4, 0, 0, 0, 1, 5
"c:\Users\Flynn\AppData\Roaming\.minecraft\saves\Hexenwerk Test World\datapacks\Hexenwerk-Datapack\data\hexenwerk\predicates\flags/has_regen.json", "JSON", 10, 0, 0, 0, 1, 11
"c:\Users\Flynn\AppData\Roaming\.minecraft\saves\Hexenwerk Test World\datapacks\Hexenwerk-Datapack\data\hexenwerk\predicates\holding/dev_stone.json", "JSON", 11, 0, 0, 0, 1, 12
"c:\Users\Flynn\AppData\Roaming\.minecraft\saves\Hexenwerk Test World\datapacks\Hexenwerk-Datapack\data\hexenwerk\predicates\holding/dev_stone_deactivated.json", "JSON", 11, 0, 0, 0, 1, 12
"c:\Users\Flynn\AppData\Roaming\.minecraft\saves\Hexenwerk Test World\datapacks\Hexenwerk-Datapack\data\hexenwerk\predicates\holding/dev_stone_debug.json", "JSON", 11, 0, 0, 0, 1, 12
"c:\Users\Flynn\AppData\Roaming\.minecraft\saves\Hexenwerk Test World\datapacks\Hexenwerk-Datapack\data\hexenwerk\predicates\holding/dev_stone_dev.json", "JSON", 11, 0, 0, 0, 1, 12
"c:\Users\Flynn\AppData\Roaming\.minecraft\saves\Hexenwerk Test World\datapacks\Hexenwerk-Datapack\data\hexenwerk\predicates\holding/wand.json", "JSON", 14, 0, 0, 0, 1, 15
"c:\Users\Flynn\AppData\Roaming\.minecraft\saves\Hexenwerk Test World\datapacks\Hexenwerk-Datapack\data\hexenwerk\predicates\holding/wand_offhand.json", "JSON", 14, 0, 0, 0, 1, 15
"c:\Users\Flynn\AppData\Roaming\.minecraft\saves\Hexenwerk Test World\datapacks\Hexenwerk-Datapack\data\hexenwerk\predicates\flags/is_in_nether.json", "JSON", 9, 0, 0, 0, 1, 10
"c:\Users\Flynn\AppData\Roaming\.minecraft\saves\Hexenwerk Test World\datapacks\Hexenwerk-Datapack\data\hexenwerk\predicates\flags/is_sneaking.json", "JSON", 9, 0, 0, 0, 1, 10
"c:\Users\Flynn\AppData\Roaming\.minecraft\saves\Hexenwerk Test World\datapacks\Hexenwerk-Datapack\data\hexenwerk\predicates\not_drowning.json", "JSON", 7, 0, 0, 0, 1, 8
"c:\Users\Flynn\AppData\Roaming\.minecraft\saves\Hexenwerk Test World\datapacks\Hexenwerk-Datapack\data\hexenwerk\recipes\magical_crafting_table.json", "JSON", 20, 0, 0, 0, 2, 22
"c:\Users\Flynn\AppData\Roaming\.minecraft\saves\Hexenwerk Test World\datapacks\Hexenwerk-Datapack\data\hexenwerk\recipes\magical_crystal.json", "JSON", 17, 0, 0, 0, 2, 19
"c:\Users\Flynn\AppData\Roaming\.minecraft\saves\Hexenwerk Test World\datapacks\Hexenwerk-Datapack\data\hexenwerk\recipes\wand.json", "JSON", 20, 0, 0, 0, 2, 22
"c:\Users\Flynn\AppData\Roaming\.minecraft\saves\Hexenwerk Test World\datapacks\Hexenwerk-Datapack\data\hexenwerk\tags\blocks\transparent.json", "JSON", 110, 0, 0, 0, 0, 110
"c:\Users\Flynn\AppData\Roaming\.minecraft\saves\Hexenwerk Test World\datapacks\Hexenwerk-Datapack\data\hexenwerk\tags\entity_types\mob.json", "JSON", 69, 0, 0, 0, 0, 69
"c:\Users\Flynn\AppData\Roaming\.minecraft\saves\Hexenwerk Test World\datapacks\Hexenwerk-Datapack\data\hexenwerk\tags\entity_types\undead.json", "JSON", 49, 0, 0, 0, 1, 50
"c:\Users\Flynn\AppData\Roaming\.minecraft\saves\Hexenwerk Test World\datapacks\Hexenwerk-Datapack\data\minecraft\tags\functions\load.json", "JSON", 3, 0, 0, 0, 0, 3
"c:\Users\Flynn\AppData\Roaming\.minecraft\saves\Hexenwerk Test World\datapacks\Hexenwerk-Datapack\data\minecraft\tags\functions\tick.json", "JSON", 3, 0, 0, 0, 0, 3
"c:\Users\Flynn\AppData\Roaming\.minecraft\saves\Hexenwerk Test World\datapacks\Hexenwerk-Datapack\pack.mcmeta", "JSON", 6, 0, 0, 0, 0, 6
"Total", "-", 1049, 1, 840, 20, 242, 2152